WWWWWWWWWWWWWWWWWWWWWWWWWWWW
WP                         W
W     W  WWWWWWWWWWWWWWWWWWW
W     W      W             W
W     W      W             W
W     W            K       W
W     W     EW             W
WWWWWWWWWWWWWWWWWWWWWWWWWWWW