WWWWWWWWWWWWWWWWWWWWWWWWWWWW
WP E                       W
WWW   WW  WWWWWWWWWWWWWWWWWW
W     W      W             W
W     W      W             W
W     W            K       W
W  K  W      W KKKKKKKKKK  W
WWWWWWWWWWWWWWWWWWWWWWWWWWWW