WWWWWWWWWWWWWWWWWWWWWWWWWWWW
WPKE                       W
WWW   WW  WWWWWWWWWWWW WWWWW
W     W      W             W
W     W      W             W
W     W      W     K       W
W     W      W             W
WWWWWWWWWWWWWWWWWWWWWWWWWWWW