WWWWWWWWWWWWWW
WP           W
W            W
W            W
W            W
W            W
W           EW
WWWWWWWWWWWWWW